7
..o......o
.o...o...
...o......
....ooo.o.
..........
.....o....
